1_1_1_1_1_1_1_1_1_1_
2_0_0_1_1_1_0_0_0_2_
0_0_0_0_0_0_0_0_0_0_
0_0_0_0_0_0_0_0_0_0_
0_0_0_0_0_0_0_0_0_0_