4_1_1_1_4_1_1_1_1_4_
3_3_2_2_2_2_2_2_3_3_
1_2_3_4_0_0_4_3_2_1_
0_0_0_0_0_0_0_0_0_0_
0_0_0_0_0_0_0_0_0_0_