1_3_3_4_4_4_4_3_3_1_
2_0_5_5_1_5_0_5_0_2_
2_1_4_3_5_3_4_2_1_2_
0_1_1_2_1_2_1_2_1_0_
3_3_3_2_2_2_2_3_3_3_