3_3_3_3_1_1_1_3_3_2_
1_2_1_2_1_2_1_2_1_2_
3_1_1_1_1_1_1_1_1_3_
0_0_0_0_0_0_0_0_0_0_
0_0_0_0_0_0_0_0_0_0_